15 40
========================================
=        ********        ++++++++++++  =                                   
=        ********        ++++++++++++  =
=        ********        ++++++++++++  =
=        ********        ++++++++++++  =
=        ********           +++++++++  =
=         **** *         ++++++++++++  =
=                        ++++++++++++  =
=                        ++++++++++++  =
=     ////////                +++++++  =
=     ////////       //////   +++++++  =
=     ////////       //////   +++++++  =
=     ////////       //////   +++++++  =
=                                      =
========================================
